111111111111111111111111111111111111111
1001000 000                       000 1
10000     0                  C       01
1P0011 0000              E           01
1001000000                           01
111111111111111111111111111111111111111
